5 5
#####
#a..#
#.@A#
#...#
#####
