5 5
#####
#.@.#
#...#
#...#
#####
